#############
#.....#.....#
#^^^^^#^^^^^#
#.....#.....#
#^^^^^#^^^^^#
#.....#.....#
#^^^^^#^^^^^#
#.....#.....#
#^^^^^#^^^^^#
#.....#.....#
#^^^^^#^^^^^#
#.....#.....#
#^^^^^#^^^^^#
#.....#.....#
#^^^^^#^^^^^#
#.....#.....#
#^^^^^#^^^^^#
#.....#.....#
#^^^^^#^^^^^#
#.....#.....#
#^^^^^#^^^^^#
#.....#.....#
#^^^^^#^^^^^#
#.....#.....#
#^^^^^#^^^^^#
#.....#.....#
#^^^^^#^^^^^#
#.....#.....#
#P....#....P#
#############