######################################
#.................#..................#
#.................#..................#
#................^##################^#
#.................#..................#
#.................#..................#
#................^#.................^#
#.................#..................#
#.................#..................#
#................^#.................^#
#.................#..................#
#................^#.................^#
#.................#..................#
#................^#.................^#
#................^#.................^#
##.....####.#####.#..###############.#
###....####.#####^##.###############^#
#..#..............#..................#
#................^#.................^#
#.................#..................#
#.................#..................#
#................^#.................^#
#.................#..................#
#.................#..................#
#................^#.................^#
#.................#..................#
#.................#..................#
#................^#.................^#
#.................#..................#
#................^#.................^#
#....#............##.#...............#
#......#.........^#.................^#
#.......#.........#.....#............#
#..........#.....^#.................^#
#.................#..................#
#................^#.......#.........^#
#.................#..................#
#P................#.................P#
######################################