####################################
....................................
....................................
....................................
....................................
....................................
....................................
....................................
....................................
....................................
....................................
....................................
....................................
....................................
#.....####.######..#################
##....####.#######.#################
..#.................................
.................#..................
....#.............#.#...............
......#..........#..................
.......#.........#.....#............
..........#......#..................
.................#..................
.................#.......#..........
....................................
P................#.................P
####################################